....................
....................
....................
....................
................GGGX
................----
...........G........
...........-........
....:..G............
....:..-............
..GGG...............
..---...............
....................
.1..................
####################
