#...............GX.#
#...........GG..--.#
#.....GGGGG.--.....#
#...GG...--........#
#...--.............#
#..GG..............#
#..--....GGGG......#
#........--..GG....#
#.......GG...--....#
#.......--.........#
#.........GG.......#
#.....GG..--.......#
#.....--...........#
#.1................#
####################
